1111111111
1P01100001
1000111011
11CE000C11
100C100001
1111111111