1111111111111
1P010001000C1
1000C10CCC001
11C01100C0E01
1111111111111