1111111111111
1P010001000C1
1000C10CCC001
11C01100C00E1
1111111111111