1111111111111
1000000000001
100000C000001
1000000000001
1000000000001
1000000000001
1000C11111001
1000000000001
100000C000001
1000000000001
1000000000001
1000000000001
1000C11111001
1000000000001
100000C000001
1000000000001
1000000000001
1000000000001
1000C11111001
1P0010E000001
1111111111111