111111
10P0C1
100001
10E001
111111