1111111111111
1CC1CCCCCC0C1
100C011111001
1P001CE0CCCC1
1111111111111