111111111111111111
1CVE000C0VVVVVC001
1000V100C000C00011
1PC0110000VVVVC001
111111111111111111