111111111111111111
1CVE0001000000C001
10000101V000C0V011
1PC00V0000V0001101
111111111111111111