111111111111111111
1CVE000CV000V0C001
1000V100C000C00011
1PC0110000V000C001
111111111111111111