1111111111111
1CC100000C0C1
100CV11111001
1P001CE0VVVC1
1111111111111