1111111111111
10V10000V00C1
1000V10000001
1P0011E000V01
1111111111111